11111111
100C0001
1E0000E1
100C0001
1E0000E1
100C0P01
100C0001
11111111